%%%%%%%%%%%%
%P . %    .% 
%%%  %%.  %%
% %. . %  .% 
%.%%   %  %%
% %.  .% . %
%   . %%   %
%.   % .  .%
%   %%%%%%%%
%%  .  %  .%
%.  %  .  %%
%%%%%%%%%%%%
