P...%    .
%%..%%.  %
 %....%   
.%% . %  %
 %. ..%  .
 . . %%   
.  %   .  
   %%%%%%%
% .  .%  .
.  %  .  %